11111111111111
1E000000000001
10100101001001
10100100101001
100000000C0001
11111111111111