1111111111111111111111111
1000C000000C00000E00000P1
1111111111111111111111111
