11111111111111
1E000000000001
11100101001001
11100100101001
1C0000000C0001
1110000P000001
11111111111110