11111111111111
1E000000000001
10100101001001
11100100101001
1C0P00000C0001
11111111111111