11111111111111
1E000000000001
11100101001001
11100100101001
1C1000000C0001
11111111111111