1111111111111111111111111
100P1001011100001000E1111
1110100100000000110011011
1000000100000011010000011
1111100001000011011110011
1100111101000010000000011
1C00000001000000111000001
1111111111111111111111111
