1111111111111111111111111111
100P1001011100001000E1111111
1110100100000000110011011111
1000000100000011010000011111
1111100001000011011110011111
1100111101000010000000011111
1C00000001000000111000001111
1111111111111111111111111111
