1111111111111111111111111
100P100101110000100001E11
1110100100000000110011111
1000000100000011010000011
11111000010C0011011110011
1100111101000010000000011
1C00000001000000111000001
1111111111111111111111111
