11111111111111
1E100000000001
11100101001001
11100100101001
1C0P00000C0001
11111111111111