11111111111111
10000000000001
11100101001001
11100100101001
1E0000000C0001
11100P00C00001
11111111111111