11111111111111
10000000000001
11100101001001
11100100101001
1E100000000001
11100P0000C001
10000000000001
10000000000001
10000000000001
11111111111111
